++++++++++++++++++++
++s++++ +++++++ ++++
++ ++++ +++++++ ++++
++          +++ ++++
+++ +++++++ +++    +
+++ +++++++ ++++++++
+++ +++++++ ++++++++
+++ +++++++      +++
+++   +++++ ++++ +++
+++++++++++ ++++ +++
+++++++++++ ++++ +++
+++++++     ++++++++
+++++++ ++++++++++++
+++++++     ++++++++
+++++++++++ ++++++++
+++++++          +++
+++++++ ++++++++++++
+       ++++++++++++
+e++++++++++++++++++
++++++++++++++++++++